1111111111111111111111
11111P0000111100001111
1111111000000011100111
11C000C11111000C111111
10000000111C000100C001
11100000C1100000000011
11110C00000C0011111111
1000000111000000000001
1E11110000000000001111
1111111111111111111111