1111111111111111
11P111111111C001
1111100000001111
11111E0000111111
1111111111111111