1111111011111
11C000111C011
110C001100111
11111P0000111
1E00000011111